#####################
#       #   #       #
# X     # X #     X #
######  #   #  ######
#         O         #
#        O#O        #
#   P   #####       #
#        O#O        #
#         O         #
######  #   #  ######
# X     # X #     X #
#       #   #       #
#####################
