###########
#        ##
# X X  X  #
#######   #
#O        #
#         #
#    O   ##
#  ########
#        ##
#         #
###### P  #
#O       ##
###########
