###################
#           #######
# ######### #######
# #       # #######
# # ##### # #######
# # #   # # #######
# # # # X # #######
# # #    O#       #
# # ####OXO X#### #
# #    OXPXO    # #
# ####X OXO#### # #
#       #O    # # #
####### # X # # # #
####### # #   # # #
####### # ##### # #
####### #       # #
####### ######### #
#######           #
###################
