WWWWWWWWWW
W  M     W
W        W
W        W
W        W
W        W
W        W
W        W
W     B  W
WWWWWWWWWW
